Natalie Morrison - Jacob Parr
Deirdre Simpson - Ian Baker
Sue Knox - Amelia Hamilton
Rebecca Howard - Wanda Lambert
Amelia Hamilton - Bella Coleman
Trevor Walsh - Lillian Tucker
Gavin Graham - Colin Lee
Charles Rampling - Joseph Abraham
Gavin Wilson - Max Paterson
Lisa Arnold - Heather Wilson
Caroline Wilson - Rebecca Howard
Christopher MacDonald - Sophie Peters
Kimberly Cameron - Julia Lyman
Gordon Skinner - Sue Knox
Julia Lyman - Lauren Pullman
Theresa Peake - Dominic Abraham
Una Martin - Dan MacLeod
Boris Robertson - Vanessa Howard
Karen Mackay - Deirdre Simpson
Dominic Abraham - Sean Quinn
Rachel Hart - Donna Bell
Stewart Watson - Austin Metcalfe
Kevin Johnston - Caroline Wilson
Ian Baker - James Gill
Alexander Anderson - Harry Ogden
Joseph Abraham - Theresa Peake
Olivia McGrath - Madeleine Peake
Jasmine Hart - Kimberly Cameron
Madeleine Peake - John Russell
Wanda Hunter - Rebecca Lyman
Emma Reid - Jasmine Hart
Austin Metcalfe - Neil Cornish
Chloe Cameron - Sophie Smith
Michelle Miller - Christopher McLean
Rose Rampling - Stewart Watson
Sophie Smith - Rose Rampling
Elizabeth Mitchell - Chloe Henderson
Lillian Tucker - Simon Oliver
Lauren Pullman - Caroline Mathis
Wanda Lambert - Sean Gray
Victor Ellison - Victoria Oliver
Neil Cornish - Donna Morrison
Sean Gray - Chloe Cameron
Matt Ogden - Lily Skinner
Victoria Oliver - Gavin Wilson
James Gill - Gordon Skinner
Carl Thomson - Lisa Arnold
Julian Duncan - Victor Ellison
Dorothy Grant - Olivia McGrath
Dan MacLeod - Rachel Hart
Megan Mackenzie - Trevor Walsh
Colin Lee - Megan Mackenzie
Christopher McLean - Michelle Miller
Max Paterson - Lucas Forsyth
Donna Morrison - Natalie Morrison
Sam Davidson - Heather Smith
Jacob Parr - Michelle Dyer
Bella Coleman - Christopher MacDonald
Joanne Thomson - Wanda Hunter
Sean Quinn - Boris Robertson
John Russell - Frank Ince
Simon Oliver - Dorothy Grant
Heather Wilson - Matt Ogden
Alexandra Glover - Ruth Clarkson
Vanessa Howard - Ian Parsons
Harry Ogden - Julian Duncan
Caroline Mathis - Emma Duncan
Alison Ball - Elizabeth Mitchell
Michelle Dyer - Alexandra Glover
Lily Skinner - Charles Rampling
Frank Ince - Alison Ball
Donna Bell - Alexander Anderson
Sophie Peters - Emma Reid
Ian Parsons - Kevin Johnston
Ruth Clarkson - Karen Mackay
Rebecca Lyman - Gavin Graham
Heather Smith - Una Martin
Chloe Henderson - Joanne Thomson
Emma Duncan - Sam Davidson
Lucas Forsyth - Carl Thomson
